xxxxx----------xxxxx
x------------------x
x------------------x
x------------------x
x------------------x
--------------------
--------------------
--------------------
--------------------
---------o----------
---------o----------
---------o----------
--------------------
--------------------
--------------------
x------------------x
x------------------x
x------------------x
x------------------x
xxxxx----------xxxxx