xxxxx--xxxxxx--xxxxx
x---x----------x---x
x---x----------x---x
x---x----------x---x
x---x----xx----x---x
---------xx---------
x--------xx--------x
x--------xx--------x
xxxxx----------xxxxx
--------oooo--------
--------------------
xxxxx----------xxxxx
x--------xx--------x
x--------xx--------x
---------xx---------
x---x----xx----x---x
x---x----------x---x
x---x----------x---x
x---x----------x---x
xxxxx--xxxxxx--xxxxx